111111111111111111111
100000000010000000001
101111011010111101101
100001010000100001001
111101011110101111101
100100000000001000001
101101111011111011101
100001000010000000001
111101011010111101101
100001010000100001001
101111011110111101101
100000000010000000001
111101011011110111101
100001000000000100001
101111011111110111101
100000000000000000001
111111111111111111111
