111111111111
100000000001
101110111101
100010100001
111010101111
100000100001
101111101101
100000000001
111111111111
