11111111111111
10000000000001
10111101111101
10000100001001
10110111011001
10000100001001
10111101111101
10000000000001
11111111111111
