1111111111111
1000000100001
1011100101111
1000100000001
1110101110101
1000101000101
1011101011101
1000000000001
1111111111111
